NO ./texture/pics/greystone.xpm
SO ./texture/pics/bluestone.xpm
WE ./texture/pics/colorstone.xpm
EA ./texture/pics/purplestone.xpm

F 0,0,255
C 0,35,155

11111111111111111111111111111111111111111111111111111111111
10000000000000000000000000000000000000000000000000000000001
100000000000000000000000000000000000000000000000000000000011111111111111111111111111111
100000000000000000000000000000000000000000000000000000000000000000000000000000000000001
100000000000000000000000000000000000000000000000000000000011111111111111111111111000011
10000000000000000000000000000000000000000000000000000000001                     100001
10000000000000000000000000000000000000000000000000000000001                     100001
10000000000000000000000000000000000000000000011100000000001                     100001
10000000000000000000000000000000000000000000110100000000001                     100001
10000000000000000000000000000000000000000001100100000000001                     100001
10000000000000000000000000000000000000000001100100000000001     111111111111111110000111111111111111111111111
1000S000000000000000000000000000000000000001000100000000001     100000000000000000000000000000000000000000001
10000000000000000000000000000000000000000001000100000000001     100000000000000000000000000000000000000000001
10000000000000000000000000000000000000000000000000000000001     100000000000000000000000000000000000000000001
10000000000000000000000000000000000000000000000000000000001     100000000000000000000000000000000000000000001
10000000000000000000000000000000000000000000000000000000001     100000000000000000001111111111000000000000001
10000000000000011111111111111111111111111111111111000000001     100000000000000000001000000001000000000000001
10000000000000010000000000000000000000000000000001000000001     100000000000000000001000000001000000000000001
10000000000000010000000000000000000000000000000001000000001     100000000000000000001111111111000000000000001
10000000000000000000000000000000000000000000000001000000001     100000000000000000000010000000000000000000001
10000000000000010000000000000000000000000000000001000000001     100000000000000000000010000000000000000000001
10000000000000010000000000000000000000000000000001000000001     100000000000000000000010000000000000000000001
10000000000000010000000000000000000000000000000001000000001     100000000000000000000010000000000000000000001
10000000000000010000000000000000000000000000000001000000001     100000000000000000000010000000000000000000001
1000000000000001000000000000000000000000000000000100000000111111100000000000000000000010000000000000000000001
1000000000000001000000000000000000000000000000000100000000000000000000000000000000000010000000000000000000001
1000000000000001000000000000000000000000000000000000000000000000000000000000000000000010000000000000000000001
1000000000000001000000000000000000000000000000000100000000111111100000000000000000000010000000000000000000001
10000000000000010000000000000000000000000000000001000000001     100000000000000000000000000000000000000000001
10000000000000010000000000000000000000000000000001000000001     100000000000000000000010000000000000000000001
10000000000000011111111111111111111111111111111111000000001     100000000000000000000010000000000000000000001
10000000000000000000000000000000000000000000000000000000001     100000000000000000000010000000000000000000001
10000000000000000000000000111111111100000000000000000000001     111111111111111111111111111111111111111111111
10000000000000000000000000100000000100000000000000000000001
10000000000000000000000000100000000100000000000000000000001
10000000000000000000000000100000000100000000000000000000001
10000000000000000000000000100000000100000000000000000000001
10000000000000000000000000000000000000000000000000000000001
11111111111111111111111111111111111111111111111111111111111
