NO ./textures/azulejo.xpm
SO ./textures/flowers.xpm
WE ./textures/window.xpm
EA ./textures/planches.xpm

F 181,86,144
C 255,154,86



 1111111
 1000001
 1E00001
 1000001
 1011111

  1