         

        101
        101111111111111111111111111
        101000000000110000000000001
        101011000001110000000000001
        101001000000000000000000001
11111111101100000111000000000000111
100000000000000001110111111111111
11110111111111000000000010001
1111011111111101110100000001
11000000110101011100000010001
10000000000000110000000010001
10000000000000111101010110001
11000001110101011111011110N0111
11110111 1110101 101111010001
11111111 1111111 111111111111
                           1